lapses	negative
sobering	negative
downsides	negative
ease	positive
low-priced	positive
mockeries	negative
liable	negative
long-lasting	positive
disarray	negative
inconsolable	negative
humming	negative
fairness	positive
throbbing	negative
diversified	positive
tidy	positive
hysterical	negative
shortness	negative
praising	positive
wrongly	negative
horrendous	negative
drastically	negative
stingingly	negative
grieving	negative
silent	positive
irksomenesses	negative
revolutionizes	positive
retreated	negative
self-interest	negative
nifty	positive
flirt	negative
marvellous	positive
vain	negative
rumple	negative
irrational	negative
rant	negative
impulsive	negative
limitation	negative
stormy	negative
tyranny	negative
mawkishness	negative
eloquently	positive
expensive	negative
wrinkles	negative
shrilly	negative
spite	negative
fearless	positive
tender	positive
painless	positive
sweetheart	positive
immaculately	positive
precise	positive
malcontented	negative
unethical	negative
refine	positive
lambaste	negative
usurp	negative
fatigued	negative
well-regarded	positive
reforms	positive
imprecision	negative
desperate	negative
wallow	negative
infamous	negative
miscellaneous	negative
ultra-crisp	positive
impious	negative
faith	positive
gimmicks	negative
struck	negative
ugly	negative
repugnantly	negative
ineffectively	negative
mind-blowing	positive
luckiness	positive
insolence	negative
stole	negative
gained	positive
dissappointing	negative
imperfections	negative
luxurious	positive
lousy	negative
screw-up	negative
gainful	positive
intractable	negative
fugitive	negative
excellent	positive
offend	negative
revives	positive
warmly	positive
ruthless	negative
rebuke	negative
poeticize	positive
doubt	negative
fictitious	negative
ingenious	positive
pugnaciously	negative
mistrustfully	negative
smallish	negative
impenitent	negative
finicky	negative
needy	negative
disbelieve	negative
rifts	negative
fell	negative
wonderously	positive
puzzlement	negative
scandalize	negative
inadequacy	negative
quaint	positive
defeats	positive
skulk	negative
subordinate	negative
goad	negative
supporter	positive
disaffected	negative
loyal	positive
freakishly	negative
iniquitous	negative
impede	negative
eviscerate	negative
tumbled	negative
nefariously	negative
errors	negative
enviably	positive
outsmart	positive
overjoyed	positive
occluding	negative
stubborn	negative
rejected	negative
uncompetitive	negative
misapprehend	negative
needlessly	negative
rapid	positive
monstrously	negative
entertains	positive
hack	negative
thumbs-down	negative
invective	negative
disdainfully	negative
sensations	positive
impoverish	negative
scars	negative
dominates	positive
talent	positive
scornfully	negative
hype	negative
useful	positive
fracture	negative
suicide	negative
incessantly	negative
racists	negative
inefficacious	negative
nice	positive
enviously	negative
expropriate	negative
feebleminded	negative
mobster	negative
reluctantly	negative
strain	negative
scrambled	negative
moronic	negative
inescapably	negative
distorts	negative
invigorating	positive
disconsolately	negative
monumentally	positive
downcast	negative
mushy	negative
irritant	negative
unruly	negative
patriotic	positive
opinionated	negative
hell	negative
positively	positive
rip	negative
ghosting	negative
invaluable	positive
treacherously	negative
passion	positive
destructive	negative
love	positive
restructure	positive
resentful	negative
tops	positive
traitorously	negative
jaundiced	negative
enthusiast	positive
unity	positive
upseting	negative
impasse	negative
gloriously	positive
qualm	negative
tediously	negative
hostilities	negative
recovery	positive
unwillingness	negative
vindictively	negative
incessant	negative
erudite	positive
threats	negative
satisified	positive
obstructs	negative
polished	positive
heckles	negative
payback	negative
drop-outs	negative
laid-off	negative
embarrass	negative
thank	positive
overtake	positive
problematic	negative
hedge	negative
insensitive	negative
losers	negative
feint	negative
traped	negative
encouragingly	positive
desert	negative
sustainability	positive
stupendous	positive
peevishly	negative
jumpy	negative
unnervingly	negative
lucrative	positive
vulgar	negative
inattentive	negative
spotless	positive
maniacal	negative
unfounded	negative
smoothest	positive
fragmented	negative
zapped	negative
upheld	positive
insightful	positive
hotheaded	negative
detest	negative
stooges	negative
witty	positive
inconsolably	negative
led	positive
unacceptably	negative
mordant	negative
well-made	positive
nauseate	negative
misses	negative
irrationally	negative
vagueness	negative
incomprehension	negative
untruthful	negative
underlings	negative
triumphantly	positive
sick	negative
despotic	negative
massacres	negative
disprove	negative
hoodwink	negative
repressive	negative
triumphant	positive
elimination	negative
excruciatingly	negative
reformed	positive
humorous	positive
dilapidated	negative
exploitation	negative
first-rate	positive
glad	positive
grumpily	negative
unmoved	negative
disgraced	negative
pamper	positive
perverted	negative
upsettingly	negative
shamefully	negative
monstrosities	negative
humourous	positive
wrought	negative
incongruous	negative
discontinued	negative
dies	negative
encourage	positive
fortitude	positive
insensitivity	negative
terrifically	positive
slut	negative
subsidizing	positive
reputable	positive
indifferent	negative
discourteously	negative
falls	negative
spectacularly	positive
deplore	negative
opportunistic	negative
impatience	negative
sorely	negative
kook	negative
knave	negative
itch	negative
wobbles	negative
nepotism	negative
unfortunately	negative
solid	positive
importune	negative
guile	negative
disturbing	negative
venomous	negative
freak	negative
poverty	negative
nastily	negative
paupers	negative
inaccurate	negative
scarce	negative
politeness	positive
woe	negative
overturn	negative
miss	negative
din	negative
misgivings	negative
fallen	negative
valuable	positive
hallowed	positive
resourcefulness	positive
lethargy	negative
nonexistent	negative
endanger	negative
uncaring	negative
disadvantageous	negative
frail	negative
villian	negative
dismissive	negative
impressiveness	positive
jitters	negative
fairly	positive
glum	negative
quicker	positive
sketchy	negative
prowess	positive
sty	negative
non-violent	positive
misery	negative
shortage	negative
traumatically	negative
worth	positive
shimmering	positive
refuted	negative
exquisitely	positive
loss	negative
hawkish	negative
dishonorable	negative
glib	negative
unwanted	negative
upset	negative
unsettled	negative
frenetically	negative
unlamentably	negative
desultory	negative
smiling	positive
gabble	negative
rubbish	negative
easiness	positive
sarcasm	negative
obtrusive	negative
ruin	negative
devilish	negative
self-humiliation	negative
dissonantly	negative
growl	negative
nourish	positive
scowl	negative
rust	negative
overzealous	negative
siege	negative
disturb	negative
irregularity	negative
proud	positive
hostile	negative
immoral	negative
scoldingly	negative
implacable	negative
spade	negative
refresh	positive
envious	negative
powerful	positive
inexcusable	negative
yawn	negative
smell	negative
perplexed	negative
uplift	positive
gaffe	negative
tanked	negative
leaks	negative
oppositions	negative
vice	negative
fetid	negative
famine	negative
tortured	negative
merriment	positive
rile	negative
malevolent	negative
distrust	negative
retractable	positive
incomprehensible	negative
indeterminate	negative
disturbed	negative
plunderer	negative
steadfastness	positive
insinuate	negative
undisputed	positive
desolate	negative
fragrant	positive
well-behaved	positive
delighted	positive
hung	negative
overshadow	negative
discredit	negative
tardy	negative
scandalous	negative
gaff	negative
rectifying	positive
effectual	positive
fist	negative
invulnerable	positive
woeful	negative
neglected	negative
dirtbag	negative
scare	negative
tempest	negative
inability	negative
veritable	positive
recklessness	negative
knowledgeable	positive
terror-genic	negative
impure	negative
forebodingly	negative
thankful	positive
dominate	positive
luck	positive
regretfully	negative
incoherent	negative
retaliatory	negative
perilous	negative
headache	negative
righteousness	positive
measly	negative
unorthodoxy	negative
smelt	negative
overtaken	positive
first-in-class	positive
unproves	negative
sincere	positive
intricate	positive
inspire	positive
smutty	negative
feature-rich	positive
punish	negative
propagandize	negative
despairing	negative
irretrievable	negative
outperforming	positive
futurestic	positive
fascinating	positive
object	negative
stolen	negative
fanatically	negative
douchebag	negative
miraculously	positive
merriness	positive
zest	positive
obsessively	negative
unsteadily	negative
promptly	positive
fabricate	negative
reluctant	negative
lame-duck	negative
prick	negative
deter	negative
extortion	negative
success	positive
unencumbered	positive
rift	negative
eschew	negative
tauntingly	negative
downgrade	negative
trick	negative
quarrels	negative
whimper	negative
inferior	negative
guiltily	negative
receptive	positive
greasy	negative
intimidate	negative
misdirection	negative
quitter	negative
victimize	negative
ill-treatment	negative
pillage	negative
protective	positive
detracting	negative
fanatics	negative
overthrows	negative
doubtfully	negative
feverish	negative
uncompromising	negative
sob	negative
villianous	negative
perfidious	negative
viewable	positive
revulsive	negative
ftw	positive
sass	negative
untrustworthy	negative
exceled	positive
invigorate	positive
puppets	negative
depressed	negative
lascivious	negative
unhealthy	negative
excitement	positive
dogmatic	negative
smuttier	negative
smudging	negative
poorest	negative
misunderstand	negative
wreck	negative
worriedly	negative
inconsistent	negative
messed	negative
entrust	positive
loud	negative
harmless	positive
procrastination	negative
negligence	negative
despondence	negative
hoodium	negative
dismissively	negative
sucks	negative
vileness	negative
pleases	positive
reforming	positive
pleasantly	positive
hells	negative
doubtless	positive
faster	positive
strictly	negative
significant	positive
insolent	negative
raping	negative
spellbindingly	positive
sorrowfully	negative
pleasurable	positive
murderer	negative
flair	negative
lagging	negative
patient	positive
scam	negative
provocative	negative
lechery	negative
mist	negative
dodgey	negative
scandals	negative
obliterate	negative
menace	negative
low-price	positive
lawless	negative
efficient	positive
unknown	negative
guilt	negative
revel	positive
strong	positive
inelegant	negative
pardon	positive
grievances	negative
stalls	negative
irreplaceable	positive
saintly	positive
dispiriting	negative
gratifyingly	positive
disobedience	negative
harmed	negative
defeated	positive
omit	negative
unmatched	positive
unauthentic	negative
enrich	positive
purposeful	positive
faithfully	positive
eyecatch	positive
exhort	negative
monotonous	negative
savvy	positive
vainly	negative
frantic	negative
fulfillment	positive
unsettlingly	negative
fortunate	positive
forsaken	negative
sorrow	negative
insanity	negative
distinctive	positive
unreasonable	negative
halcyon	positive
haste	negative
hysterics	negative
protection	positive
ill-defined	negative
midget	negative
poisonously	negative
slow-moving	negative
err	negative
spoonfed	negative
finely	positive
memorable	positive
illusory	negative
sugar-coated	negative
two-faced	negative
unnecessary	negative
idiotic	negative
indistinguishable	negative
licentious	negative
lovelorn	negative
strife	negative
unreasonably	negative
pre-eminent	positive
hegemonistic	negative
inexpiable	negative
gutter	negative
lively	positive
jeopardy	negative
peeved	negative
nebulous	negative
depressingly	negative
die-hard	negative
frugal	positive
vagrant	negative
lacked	negative
graft	negative
misjudgment	negative
irreformable	negative
outwit	positive
parasite	negative
fears	negative
enraptured	positive
preoccupy	negative
unwilling	negative
wickedly	negative
perfect	positive
overdo	negative
sham	negative
implication	negative
ruthlessly	negative
disagrees	negative
loves	positive
forceful	negative
hegemony	negative
painlessly	positive
longingly	negative
palatial	positive
misgiving	negative
horrifies	negative
harmony	positive
incommensurate	negative
killed	negative
unfinished	negative
desititute	negative
gawk	negative
disheartening	negative
lamentable	negative
happily	positive
inadequate	negative
well-mannered	positive
exasperated	negative
unwelcome	negative
misbecoming	negative
dismally	negative
unimaginable	negative
renown	positive
rational	positive
reprove	negative
mistress	negative
heroically	positive
dissatisfy	negative
enliven	positive
incoherence	negative
perfunctory	negative
stubbornly	negative
grateful	positive
pepping	positive
talented	positive
insanely	negative
magnificently	positive
tingle	positive
stunned	positive
irrationals	negative
horrible	negative
disorganized	negative
ghastly	negative
unwell	negative
selfishness	negative
enthusiasm	positive
ineptly	negative
stimulate	positive
openly	positive
low-risk	positive
prosecute	negative
latency	negative
lesser-known	negative
stuttering	negative
interrupt	negative
excessive	negative
shortcomings	negative
tangled	negative
sued	negative
rewarding	positive
mistrustful	negative
enthusiastically	positive
disgraceful	negative
disappointment	negative
squeaky	negative
lean	positive
faltered	negative
radicalization	negative
irritated	negative
prickle	negative
wounds	negative
rumor	negative
unlamentable	negative
lethal	negative
gnawing	negative
goon	negative
joker	negative
incautious	negative
immorality	negative
humorously	positive
enviously	positive
nag	negative
interfere	negative
expired	negative
relish	positive
stringent	negative
regress	negative
mawkish	negative
secretive	negative
unreliability	negative
lovable	positive
pandering	negative
inconsistencies	negative
over-valuation	negative
ebulliently	positive
masterpieces	positive
lonely	negative
wanton	negative
unconfirmed	negative
uproarous	negative
screwy	negative
harmonize	positive
foolishness	negative
unwisely	negative
raptureously	positive
ironically	negative
ho-hum	negative
flicering	negative
pampered	positive
flak	negative
unjust	negative
involuntarily	negative
provocation	negative
thorny	negative
despondent	negative
rage	negative
tortuous	negative
infuriate	negative
prejudicial	negative
tortures	negative
exasperate	negative
frenzied	negative
violator	negative
desecrate	negative
propitiously	positive
stylish	positive
hooray	positive
unquestionably	positive
wariness	negative
exhilarating	positive
isolate	negative
incredulously	negative
fastest	positive
hazardous	negative
dissuade	negative
fancy	positive
phobia	negative
thriving	positive
jeeringly	negative
irate	negative
perplexing	negative
partiality	negative
insufferable	negative
punctual	positive
malodorous	negative
madness	negative
feisty	positive
torturous	negative
unfettered	positive
unfamiliar	negative
disloyalty	negative
sweet	positive
recalcitrant	negative
plebeian	negative
glower	negative
moody	negative
lugubrious	negative
unavailable	negative
puzzling	negative
deterioration	negative
self-defeating	negative
indiscreetly	negative
precipitate	negative
virulently	negative
sharper	positive
sufferers	negative
scornful	negative
gentle	positive
zealous	negative
high-spirited	positive
pampers	positive
notably	positive
inconsistence	negative
fair	positive
slaves	negative
troubled	negative
embarrassment	negative
madden	negative
dripped	negative
nauseating	negative
tetchily	negative
error	negative
top-heavy	negative
redeem	positive
discontented	negative
spirited	positive
striking	positive
jealous	negative
pure	positive
proving	positive
loose	negative
precariously	negative
ripoff	negative
unimportant	negative
scarily	negative
shiny	positive
swelling	negative
gains	positive
dissappointed	negative
loved	positive
god-given	positive
stereotypical	negative
writhe	negative
hottest	positive
ineffective	negative
stunningly	positive
tormented	negative
ricer	negative
smartest	positive
diligent	positive
paralize	negative
temper	negative
kill	negative
famished	negative
deteriorating	negative
retarded	negative
skeptic	negative
scenic	positive
negate	negative
hobble	negative
impartiality	positive
prefer	positive
unsuccessful	negative
light-hearted	positive
nourishing	positive
rockstars	positive
falsely	negative
downturns	negative
enlightenment	positive
reaffirmation	positive
hale	positive
realistic	positive
shine	positive
serenity	positive
unexplained	negative
derogatory	negative
opposition	negative
distraught	negative
lying	negative
hesitant	negative
fierce	negative
monstrous	negative
fretful	negative
seething	negative
sloppily	negative
noisier	negative
setback	negative
misinformed	negative
posh	positive
totalitarian	negative
neatest	positive
scold	negative
two-faces	negative
superficiality	negative
execrate	negative
romantically	positive
sorry	negative
invalidate	negative
salutary	positive
displace	negative
unlikely	negative
disintegration	negative
tamper	negative
hideous	negative
oversimplification	negative
high-quality	positive
hasty	negative
overwhelms	negative
panic	negative
disconsolation	negative
incomparable	negative
disillusion	negative
fake	negative
improbability	negative
treason	negative
impressed	positive
dedicated	positive
threatening	negative
irragularity	negative
disservice	negative
nervous	negative
weak	negative
relentless	negative
enlighten	positive
zap	negative
water-down	negative
distressingly	negative
prejudices	negative
handsomely	positive
monumental	positive
erosion	negative
resignation	negative
displeasing	negative
perplexity	negative
loner	negative
dwindling	negative
toll	negative
treachery	negative
unsuccessfully	negative
skill	positive
empathize	positive
frustrating	negative
exhausts	negative
dissatisfactory	negative
lonesome	negative
lawfully	positive
misread	negative
unaffected	positive
dispensable	negative
treasonous	negative
lapsed	negative
interests	positive
dim	negative
flout	negative
dissenter	negative
scoffingly	negative
godsend	positive
trophy	positive
failed	negative
overture	positive
inhumanity	negative
jeer	negative
pedantic	negative
delectable	positive
grudgingly	negative
illuminating	positive
smelly	negative
judders	negative
vehemently	negative
nightmarish	negative
thoughtful	positive
lame	negative
openness	positive
wedge	negative
thoughtless	negative
distrustful	negative
orphan	negative
upsetting	negative
objections	negative
improbable	negative
jabber	negative
pimple	negative
persevere	positive
vigilance	positive
remorse	negative
frenzy	negative
improbably	negative
shock	negative
rock-stars	positive
snags	negative
irresistible	positive
detachable	positive
spew	negative
handsome	positive
excites	positive
sturdy	positive
mess	negative
gimmicked	negative
mendacious	negative
procrastinate	negative
discoutinous	negative
downer	negative
discourteous	negative
rash	negative
reasonably	positive
sufficient	positive
sustainable	positive
resurgent	negative
lover	positive
incompetence	negative
misguide	negative
protracted	negative
miscreants	negative
homage	positive
sag	negative
disappointments	negative
snobs	negative
marvelled	positive
unrestricted	positive
decent	positive
nasty	negative
deviate	negative
expulse	negative
mistakes	negative
pertinaciously	negative
well	positive
offenses	negative
inconvenience	negative
suicidal	negative
fateful	negative
picturesque	positive
whiny	negative
enviable	positive
thumb-up	positive
trivialize	negative
invidious	negative
questionable	negative
decency	positive
disconcertingly	negative
fatally	negative
imaculate	positive
inflexible	negative
heroine	positive
favour	positive
providence	positive
insincere	negative
malevolence	negative
inspiring	positive
enhanced	positive
knife	negative
noisy	negative
obstinate	negative
impulsively	negative
stark	negative
struggle	negative
safely	positive
fresher	positive
maniac	negative
incitement	negative
stiffness	negative
panicking	negative
devastating	negative
mismanage	negative
overthrow	negative
intimacy	positive
unequivocally	positive
villains	negative
slack	negative
eruptions	negative
groundless	negative
inhumane	negative
galore	positive
irking	negative
gleeful	positive
pretence	negative
quash	negative
flees	negative
passiveness	negative
freaks	negative
despicably	negative
enraged	negative
impediment	negative
regrettable	negative
stagnation	negative
holy	positive
mindlessly	negative
oppressiveness	negative
gravely	negative
forbidding	negative
ludicrous	negative
traumatize	negative
disagree	negative
vengeful	negative
temptingly	positive
ill-designed	negative
sagging	negative
insociable	negative
wrest	negative
warlike	negative
scandalized	negative
snobbish	negative
ridiculous	negative
well-backlit	positive
embroil	negative
thrills	positive
redemption	positive
non-violence	positive
pry	negative
sin	negative
dignify	positive
ugliness	negative
irrelevant	negative
impeach	negative
frustration	negative
downside	negative
irritating	negative
powerfully	positive
disrespectfully	negative
neatly	positive
tense	negative
unthinkably	negative
flawless	positive
idolized	positive
dispiritedly	negative
inhospitality	negative
reassurance	positive
paralyzed	negative
dick	negative
fooled	negative
frustrated	negative
unprofitable	negative
dust	negative
graciously	positive
insolvent	negative
grouse	negative
refunded	positive
dirt-cheap	positive
macabre	negative
horrifys	negative
geezer	negative
worn	negative
peculiar	negative
wrip	negative
slumpping	negative
guarantee	positive
inefficacy	negative
flicker	negative
stupify	negative
drawback	negative
satisfy	positive
tenacious	positive
omission	negative
inefficiently	negative
engulf	negative
disapproving	negative
succumb	negative
satisfies	positive
offensiveness	negative
wisdom	positive
worry	negative
gorgeous	positive
enjoin	negative
prominence	positive
inconveniently	negative
skepticism	negative
suffering	negative
leaking	negative
massacre	negative
madman	negative
infirm	negative
rebellious	negative
honesty	positive
proficiently	positive
vengefully	negative
keen	positive
resounding	positive
pamperedness	positive
errant	negative
extol	positive
reassure	positive
excelled	positive
evasion	negative
tantalizingly	positive
hestitant	negative
unrivaled	positive
mudslinger	negative
renunciation	negative
glorify	positive
picketed	negative
loathe	negative
randomly	negative
precarious	negative
sinful	negative
harms	negative
hurted	negative
sickeningly	negative
precious	positive
gold	positive
sporadic	negative
rightness	positive
unlawfully	negative
revoltingly	negative
inconsequent	negative
thicker	negative
disquieting	negative
hefty	negative
gallantly	positive
stunted	negative
satisfactorily	positive
perturb	negative
fear	negative
ecstatically	positive
disrespect	negative
disses	negative
fondness	positive
stall	negative
discouragingly	negative
satisfied	positive
refusing	negative
tyrannically	negative
foolishly	negative
outperformed	positive
disastrously	negative
impersonal	negative
uncomfortably	negative
scandel	negative
upgradeable	positive
thug	negative
infuriating	negative
smugly	negative
derisively	negative
disaccord	negative
unfaithful	negative
impossiblity	negative
hopelessness	negative
sweeten	positive
haggle	negative
extremists	negative
hegemonism	negative
wripped	negative
premier	positive
dismal	negative
strident	negative
overstatement	negative
inept	negative
genial	positive
emphatic	negative
immaterial	negative
over-acted	negative
irresolute	negative
racist	negative
lament	negative
flimflam	negative
savior	positive
undermines	negative
shamelessness	negative
forbidden	negative
illusion	negative
despot	negative
deft	positive
immense	positive
smuttiest	negative
wasted	negative
prefers	positive
verifiable	positive
inconsistency	negative
mortifying	negative
tremendously	positive
qualms	negative
stimulates	positive
gorgeously	positive
disvalue	negative
solidarity	positive
gracious	positive
rumors	negative
mistakenly	negative
maddening	negative
missed	negative
discrimination	negative
fluster	negative
marginally	negative
flakieness	negative
satirical	negative
indoctrinate	negative
venerate	positive
deploring	negative
preposterously	negative
persecute	negative
throttle	negative
gladly	positive
thrilled	positive
tickle	positive
malaise	negative
disable	negative
qualify	positive
gratifying	positive
hard-liner	negative
unlucky	negative
heresy	negative
lost	negative
hum	negative
polemize	negative
rejoicingly	positive
molest	negative
heathen	negative
drunk	negative
gaily	positive
licentiousness	negative
gratitude	positive
rejects	negative
lavish	positive
donside	negative
respectful	positive
stereotype	negative
superstition	negative
shameless	negative
refund	positive
liars	negative
exasperating	negative
unyielding	negative
disintegrates	negative
sumptuous	positive
kooky	negative
thrash	negative
downhill	negative
mispronounced	negative
restructured	positive
downfallen	negative
unclear	negative
grudging	negative
poisonous	negative
incredibly	positive
falling	negative
discordance	negative
reprimand	negative
twinkly	positive
farcical	negative
disagreeable	negative
lawlessness	negative
oasis	positive
intuitive	positive
whips	negative
prisoner	negative
steal	negative
user-friendly	positive
jollify	positive
extremism	negative
zealously	negative
deviation	negative
sumptuousness	positive
molestation	negative
ill-treated	negative
reaffirm	positive
glowingly	positive
sabotage	negative
unsteadiness	negative
hard-line	negative
feasible	positive
unspecified	negative
doomsday	negative
enemies	negative
unpredictable	negative
pretentious	negative
famed	positive
torment	negative
shunned	negative
floundering	negative
mediocrity	negative
irksome	negative
impetuous	negative
irredeemably	negative
heavenly	positive
uncompromisingly	negative
patiently	positive
marginal	negative
indulgent	positive
understandable	positive
issue-free	positive
fast-paced	positive
dispute	negative
modest	positive
invincibility	positive
displease	negative
traitorous	negative
tough	positive
inflame	negative
inapt	negative
enrapt	positive
recomend	positive
pinch	negative
troublesomely	negative
illicit	negative
triumph	positive
treacherous	negative
dings	negative
fans	positive
regression	negative
mercifully	positive
vibrating	negative
impressive	positive
farcically	negative
salacious	negative
lengthy	negative
discontentedly	negative
disgust	negative
gimmick	negative
denying	negative
reticent	negative
rightly	positive
upgradable	positive
indelicate	negative
timid	negative
restrictive	negative
unacceptable	negative
traction	positive
nonresponsive	negative
effrontery	negative
fanciful	negative
zealot	negative
primitive	negative
relentlessness	negative
tin-y	negative
plush	positive
remorselessness	negative
dissent	negative
disarm	negative
taint	negative
extermination	negative
sneaky	negative
qualified	positive
disadvantages	negative
excitedness	positive
gallant	positive
disagreement	negative
pleas	negative
magnanimous	positive
exult	positive
dreadfully	negative
knock	negative
unnerved	negative
important	positive
lag	negative
smother	negative
eagerness	positive
hysterically	negative
manipulators	negative
overbearing	negative
untimely	negative
idiots	negative
manipulation	negative
neurotically	negative
profound	positive
well-received	positive
lier	negative
subjected	negative
imbalance	negative
impresses	positive
fails	negative
thankless	negative
pitifully	negative
principled	positive
lurch	negative
detests	negative
vanity	negative
jarring	negative
virtuous	positive
obsessive	negative
ingratitude	negative
smelled	negative
troublingly	negative
humble	positive
glitter	positive
serene	positive
staid	negative
stupidity	negative
sap	negative
languorously	negative
intelligible	positive
loot	negative
intolerablely	negative
refined	positive
stubbornness	negative
suffocate	negative
wretch	negative
wiles	negative
low-rated	negative
retards	negative
infringement	negative
improper	negative
proper	positive
somber	negative
thumb-down	negative
sluggish	negative
malignant	negative
fearful	negative
discountenance	negative
shockingly	negative
harmful	negative
spurn	negative
gaiety	positive
successful	positive
wobble	negative
unaccustomed	negative
oversimplified	negative
impassioned	positive
elegance	positive
solicitous	positive
motionless	negative
disintegrated	negative
gush	positive
willing	positive
savaged	negative
influential	positive
superbly	positive
ruins	negative
vouch	positive
refreshed	positive
fat-cat	negative
egocentric	negative
recommended	positive
unusual	negative
sugar-coat	negative
sloooooooooooooow	negative
extraneous	negative
fallacies	negative
unnerve	negative
soundness	positive
liberate	positive
worse	negative
unbiased	positive
far-fetched	negative
kills	negative
victorious	positive
dullard	negative
master	positive
unresponsive	negative
wayward	negative
disinterested	negative
won	positive
weaker	negative
undocumented	negative
mangle	negative
lack	negative
tarnish	negative
sneering	negative
undercut	negative
infest	negative
trouble-free	positive
smartly	positive
squeals	negative
lionhearted	positive
head-aches	negative
uneasy	negative
disbeliever	negative
superficial	negative
dull	negative
eulogize	positive
sturdier	positive
outdone	positive
insincerely	negative
grumpier	negative
uneconomical	negative
dying	negative
excoriate	negative
temerity	negative
false	negative
skeptical	negative
pitiless	negative
lawbreaking	negative
erratically	negative
tangle	negative
plot	negative
triumphal	positive
lose	negative
peps	positive
orderly	positive
stodgy	negative
prettily	positive
hectic	negative
fever	negative
unusually	negative
durable	positive
threesome	negative
regreted	negative
overbalance	negative
distrusting	negative
submissive	negative
tedious	negative
gratefully	positive
loathsome	negative
dissolution	negative
onslaught	negative
insecure	negative
unorthodox	negative
ferocity	negative
wasteful	negative
regrettably	negative
subsidized	positive
threat	negative
frightfully	negative
diss	negative
lackeys	negative
desolation	negative
vent	negative
gentlest	positive
dishonesty	negative
skeptically	negative
refreshing	positive
wrongful	negative
tumble	negative
steadfast	positive
senselessly	negative
dissatisfying	negative
layoff-happy	negative
leaky	negative
fatuous	negative
malady	negative
devilment	negative
invisible	negative
revive	positive
jaw-dropping	positive
hard-working	positive
eased	positive
indeterminably	negative
winning	positive
truthfully	positive
popular	positive
rail	negative
grief	negative
imminence	negative
embarrassingly	negative
incredible	positive
graceless	negative
pariah	negative
prohibit	negative
ovation	positive
salute	positive
screech	negative
insulted	negative
odder	negative
finer	positive
pep	positive
loving	positive
reliably	positive
gawky	negative
downbeat	negative
unforeseen	negative
protested	negative
sceptical	negative
insurrection	negative
spitefully	negative
disgruntle	negative
impetuously	negative
hero	positive
disappointed	negative
haughty	negative
monster	negative
overzelous	negative
masterfully	positive
heckle	negative
rightfully	positive
inaccurately	negative
rumbling	negative
slanderous	negative
fruitless	negative
supurb	positive
fussy	negative
fatique	negative
slooow	negative
mishandle	negative
entrapment	negative
grumpy	negative
excels	positive
weary	negative
impeccable	positive
desolately	negative
erodes	negative
pollute	negative
ineffectualness	negative
masterful	positive
smack	negative
dilemma	negative
extremist	negative
intimidating	negative
trust	positive
disreputable	negative
tougher	positive
rogue	negative
hamper	negative
dumps	negative
slowwww	negative
impolite	negative
diligently	positive
survivor	positive
pluses	positive
sully	negative
hellion	negative
punk	negative
exultant	positive
scratch	negative
heckled	negative
facetiously	negative
dynamic	positive
snappy	positive
irony	negative
imperfectly	negative
renewed	positive
depressions	negative
rascals	negative
progress	positive
unreal	positive
pandemonium	negative
readily	positive
geekier	positive
obscenity	negative
morbidly	negative
shriek	negative
majestic	positive
disappointing	negative
idealize	positive
richer	positive
sinister	negative
jaded	negative
sickening	negative
prize	positive
weed	negative
messy	negative
frantically	negative
left-leaning	negative
maliciousness	negative
hangs	negative
ungovernable	negative
well-educated	positive
forsake	negative
limit	negative
incompatible	negative
judder	negative
exasperatingly	negative
stunt	negative
fraud	negative
foulness	negative
unequal	negative
maladjustment	negative
hinder	negative
devilry	negative
hurting	negative
playfully	positive
respect	positive
extoll	positive
immoderately	negative
priceless	positive
sparkle	positive
illegal	negative
hell-bent	negative
eager	positive
idyllic	positive
resentment	negative
infringe	negative
sweetly	positive
tiringly	negative
exceeds	positive
gladden	positive
misbehave	negative
inimical	negative
heretic	negative
rankle	negative
un-viewable	negative
nettlesome	negative
outburst	negative
joyful	positive
shambles	negative
opponent	negative
manic	negative
stifling	negative
illumine	positive
fustigate	negative
fortuitous	positive
uproot	negative
funky	negative
indecisive	negative
inconceivable	negative
mindless	negative
privileged	positive
standstill	negative
goood	positive
stabilize	positive
refutation	negative
inpressed	positive
jutters	negative
stagnate	negative
sufficed	positive
shallow	negative
intimidation	negative
insensitively	negative
succeeded	positive
unconvincing	negative
wreaked	negative
low-cost	positive
overtook	positive
touchy	negative
wily	negative
melodramatic	negative
waning	negative
luxury	positive
happier	positive
selfish	negative
peculiarly	negative
diabolic	negative
hampered	negative
shark	negative
enough	positive
facetious	negative
gems	positive
shit	negative
ill-natured	negative
harmonious	positive
gloom	negative
idiotically	negative
vile	negative
raving	negative
undid	negative
disbelief	negative
exaltation	positive
unfairly	negative
murky	negative
trustingly	positive
felicitous	positive
smoke	negative
uproar	negative
expropriation	negative
unwatchable	negative
meaningless	negative
extravagance	negative
implausibly	negative
rapt	positive
rejuvenated	positive
uncollectible	negative
peeve	negative
spookier	negative
disaffect	negative
illustrious	positive
distaste	negative
thrillingly	positive
struggled	negative
rancor	negative
tetchy	negative
worrisome	negative
impermissible	negative
gainsay	negative
hedonistic	negative
improperly	negative
loathing	negative
hatred	negative
overkill	negative
divinely	positive
inexperienced	negative
joyfully	positive
regard	positive
shun	negative
frustratingly	negative
fiend	negative
manipulative	negative
hypocritical	negative
mania	negative
lighter	positive
destiny	positive
uneventful	negative
misbegotten	negative
dropout	negative
impudence	negative
egotism	negative
overweight	negative
impossible	negative
vibrant	positive
reverence	positive
merrily	positive
scoff	negative
disunity	negative
insolently	negative
niggle	negative
symptoms	negative
stab	negative
dusty	negative
ill-advised	negative
meddlesome	negative
uncontrolled	negative
distorted	negative
injury	negative
frenetic	negative
deservedly	positive
unreadable	negative
terrorism	negative
mirage	negative
injustices	negative
rocky	negative
poor	negative
wieldy	positive
repulsing	negative
obsolete	negative
doddering	negative
smelling	negative
immovable	negative
idiot	negative
ethical	positive
exalted	positive
raped	negative
fume	negative
successes	positive
unrelenting	negative
farcical-yet-provocative	negative
entrancing	positive
loneliness	negative
jubilantly	positive
prompt	positive
muddle	negative
resourceful	positive
disregard	negative
titillating	positive
worried	negative
hypocricy	negative
peace	positive
meaningful	positive
troubles	negative
revival	positive
misaligns	negative
funny	negative
intrusion	negative
intolerance	negative
hassle	negative
goof	negative
mangles	negative
mournfully	negative
properly	positive
mesmerizingly	positive
indiscreet	negative
fecilitous	positive
hardship	negative
sleazy	negative
evil	negative
easing	positive
lagged	negative
vomits	negative
scarcely	negative
ruffle	negative
illogic	negative
garbage	negative
meticulous	positive
shortcoming	negative
tempting	positive
madder	negative
lethargic	negative
unworthy	negative
recant	negative
grievous	negative
revolutionize	positive
embroiled	negative
drained	negative
disgruntled	negative
volatility	negative
pillory	negative
visionary	positive
hissed	negative
humiliating	negative
foolish	negative
fallacy	negative
distinguished	positive
ennoble	positive
staunchness	positive
helped	positive
wildly	negative
efficiently	positive
vigilant	positive
divisiveness	negative
grimace	negative
giddy	negative
indignity	negative
stigma	negative
venomously	negative
subsidizes	positive
mischief	negative
disapprobation	negative
scummy	negative
misbecome	negative
seasoned	positive
works	positive
snarl	negative
straggler	negative
lower-priced	positive
zaps	negative
protest	negative
self-serving	negative
tiring	negative
illuminate	positive
swelled	negative
imposition	negative
womanizing	negative
sly	negative
distinction	positive
peaceful	positive
dimmer	negative
devastation	negative
rue	negative
dragged	negative
throb	negative
trouble	negative
unipolar	negative
insular	negative
obstinately	negative
sunk	negative
generously	positive
irreversible	negative
viciously	negative
quarrel	negative
life-threatening	negative
support	positive
toughness	negative
energetic	positive
spoiled	negative
transparent	positive
stumbled	negative
mists	negative
hysteria	negative
disapproval	negative
desperation	negative
err-free	positive
revolting	negative
snobish	negative
prosperity	positive
reprehensibly	negative
defender	positive
overrun	negative
excelent	positive
evildoer	negative
entanglement	negative
extravagantly	negative
interference	negative
strut	negative
subtract	negative
rigid	negative
elatedly	positive
innovation	positive
wane	negative
productively	positive
miraculousness	positive
impiety	negative
undecided	negative
uneasiness	negative
parody	negative
wreak	negative
heaven	positive
supreme	positive
well-balanced	positive
watered-down	negative
revile	negative
handily	positive
mesmerized	positive
wonderous	positive
haunt	negative
enticingly	positive
over-priced	negative
drawbacks	negative
frustrate	negative
hideousness	negative
simplistically	negative
grievance	negative
friendliness	positive
fanfare	positive
neat	positive
disappoints	negative
forlornly	negative
peevish	negative
squash	negative
lewdly	negative
instantly	positive
liberation	positive
setbacks	negative
gooood	positive
exemplar	positive
fidget	negative
unselfish	positive
hopelessly	negative
dislikes	negative
reform	positive
flagging	negative
discordant	negative
unsustainable	negative
disallow	negative
remedy	positive
dissidents	negative
derision	negative
fabrication	negative
glisten	positive
disorient	negative
versatility	positive
numb	negative
useable	positive
scams	negative
picketing	negative
keenly	positive
nitpicking	negative
stooge	negative
losing	negative
drippy	negative
uncouth	negative
dubiously	negative
posturing	negative
sub-par	negative
faithful	positive
razor-sharp	positive
winner	positive
passionately	positive
shocking	negative
maddeningly	negative
dismay	negative
pleasingly	positive
scolding	negative
immobilized	negative
dumbfounding	positive
marvelous	positive
sagely	positive
vociferous	negative
eminence	positive
indecently	negative
irritably	negative
diligence	positive
revere	positive
restriction	negative
ranting	negative
involuntary	negative
maturity	positive
tenacity	positive
inhuman	negative
inflict	negative
poignant	positive
lurking	negative
prison	negative
harshly	negative
flagrantly	negative
plaything	negative
plagiarize	negative
inevitably	negative
recommendations	positive
unfit	negative
layoff	negative
messing	negative
radicals	negative
improving	positive
volatile	negative
flourishing	positive
helplessly	negative
disintegrate	negative
imprecisely	negative
kindly	positive
unobserved	negative
quarrelsome	negative
tranquility	positive
merciless	negative
sue	negative
fainthearted	negative
indebted	positive
distraughtly	negative
enrichment	positive
hothouse	negative
safe	positive
flickers	negative
harassed	negative
violation	negative
jubilate	positive
fractious	negative
reproach	negative
heartily	positive
reprehension	negative
indecision	negative
fearsome	negative
trap	negative
relent	positive
fleeing	negative
hearten	positive
succes	positive
mystery	negative
froze	negative
win	positive
renounce	negative
smolder	negative
undisputably	positive
exaltingly	positive
incorrigibly	negative
personalized	positive
gutsy	positive
irredeemable	negative
mourn	negative
purify	positive
freaking	negative
generosity	positive
earnestly	positive
unsafe	negative
polution	negative
tension	negative
drains	negative
irrationalities	negative
intermittent	negative
loveliness	positive
grin	positive
flexible	positive
work	positive
virulence	negative
sagacity	positive
gleefully	positive
survival	positive
pittance	negative
pernicious	negative
junk	negative
unavoidably	negative
supporting	positive
unlawful	negative
smilingly	positive
election-rigger	negative
unilateralism	negative
haters	negative
quieter	positive
misconception	negative
gratifies	positive
pretty	positive
regretful	negative
faithless	negative
spiteful	negative
laud	positive
meltdown	negative
subjugation	negative
misbehavior	negative
feckless	negative
sloth	negative
limits	negative
insecurity	negative
washed-out	negative
oddly	negative
squealing	negative
self-destructive	negative
tentative	negative
liked	positive
tarnishing	negative
wail	negative
insubstantial	negative
jealousy	negative
mistrust	negative
smut	negative
detested	negative
misinterpret	negative
overstatements	negative
eyecatching	positive
peerless	positive
freeze	negative
lunaticism	negative
treasure	positive
mournful	negative
mercy	positive
reasonable	positive
shrouded	negative
enthrall	positive
disinclination	negative
impinge	negative
unbelievably	negative
jubiliant	positive
intelligence	positive
vehement	negative
sanctimonious	negative
unbearable	negative
heartfelt	positive
indecency	negative
hardliners	negative
wonder	positive
irresolvable	negative
inane	negative
nightmare	negative
falsehood	negative
unspeakable	negative
masters	positive
premeditated	negative
offending	negative
fallaciously	negative
inculcate	negative
intrigue	positive
murderous	negative
shamelessly	negative
douchbag	negative
spellbind	positive
scum	negative
reconciliation	positive
mediocre	negative
long-winded	negative
optimistic	positive
gallingly	negative
pertinacious	negative
easiest	positive
dissed	negative
poison	negative
unstable	negative
implode	negative
disapprove	negative
feat	positive
lawbreaker	negative
outstanding	positive
hallucinate	negative
haggard	negative
indecorum	negative
unjustly	negative
feeble	negative
indiscriminately	negative
infiltrators	negative
trashy	negative
knotted	negative
saint	positive
inequality	negative
reachable	positive
over-awe	negative
discouraging	negative
generous	positive
horrific	negative
ignominious	negative
insinuation	negative
deterrent	negative
gross	negative
horrify	negative
roomy	positive
manipulate	negative
noises	negative
merry	positive
fervid	positive
misunderstandings	negative
indifference	negative
smooth	positive
racism	negative
relaxed	positive
heartbreaking	negative
inevitable	negative
dissing	negative
sane	positive
odd	negative
injure	negative
permissible	positive
iniquity	negative
righteously	positive
recommendation	positive
genocide	negative
shrug	negative
shiver	negative
ill-mannered	negative
embolden	positive
notoriety	negative
wripping	negative
thrift	positive
goofy	negative
sink	negative
unrealistic	negative
fidelity	positive
excited	positive
insidiously	negative
swankier	positive
dictator	negative
disown	negative
outrage	negative
nastiness	negative
soapy	negative
dissatisfied	negative
impartially	positive
intrusive	negative
longing	negative
inefficient	negative
encroachment	negative
dinky	negative
speedily	positive
denunciations	negative
scant	negative
spook	negative
wobbled	negative
reprovingly	negative
spotty	negative
rusts	negative
humility	positive
sloooow	negative
stereotypically	negative
zombie	negative
spoilage	negative
melancholy	negative
perseverance	positive
overdone	negative
idol	positive
slanders	negative
fatty	negative
squander	negative
prodigiously	positive
frighteningly	negative
intriguingly	positive
lucidly	positive
grapple	negative
fancinating	positive
outperform	positive
glare	negative
hurt	negative
peacefully	positive
misleading	negative
greedy	negative
stingy	negative
harsh	negative
hassles	negative
unforgiving	negative
fatcat	negative
prejudge	negative
escapade	negative
pinnacle	positive
remorsefully	negative
gifted	positive
humor	positive
ugliest	negative
magical	positive
magnificence	positive
overstate	negative
freshest	positive
gainsayer	negative
servitude	negative
valiantly	positive
frown	negative
musty	negative
impaired	negative
stale	negative
refusal	negative
mistaken	negative
relentlessly	negative
savagery	negative
sadness	negative
gullible	negative
stirringly	positive
dogged	negative
warned	negative
sufferer	negative
nonsense	negative
discomfit	negative
incivility	negative
worthiness	positive
laggy	negative
detrimental	negative
mastery	positive
hotcake	positive
sadly	negative
uproarious	negative
spookily	negative
remorseless	negative
smudges	negative
unhappiness	negative
tainted	negative
upbeat	positive
illogically	negative
greed	negative
heartwarming	positive
lustrous	positive
exterminate	negative
freezes	negative
irksomeness	negative
thrive	positive
exagerate	negative
mocking	negative
squirm	negative
semi-retarded	negative
menacing	negative
tranquil	positive
enhancement	positive
scream	negative
large-capacity	positive
elate	positive
ignominiously	negative
stylized	positive
leech	negative
discriminate	negative
tacky	negative
hoax	negative
unqualified	negative
soothe	positive
trickery	negative
prickles	negative
flairs	negative
foolhardy	negative
stellar	positive
headway	positive
nicest	positive
eccentric	negative
redeeming	positive
spewing	negative
marvelously	positive
excitingly	positive
scorching	negative
wonderfully	positive
well-positioned	positive
dissonance	negative
despair	negative
stately	positive
protect	positive
obsess	negative
imbroglio	negative
troublesome	negative
overtakes	positive
immoderate	negative
indoctrination	negative
drab	negative
pest	negative
dirtbags	negative
gimmicking	negative
dissembler	negative
disoobedient	negative
distort	negative
exquisite	positive
negatives	negative
tenderness	negative
hopeful	positive
offence	negative
insult	negative
undercutting	negative
eloquence	positive
squeak	negative
sardonically	negative
easier	positive
insignificance	negative
poised	positive
excitedly	positive
sullen	negative
perfidity	negative
monstrosity	negative
endear	positive
derisiveness	negative
jubilation	positive
ignore	negative
misaligned	negative
pricey	negative
fleed	negative
exultingly	positive
stampede	negative
regressive	negative
repel	negative
gladness	positive
glimmering	positive
petty	negative
frictions	negative
steep	negative
plea	negative
disdainful	negative
swanky	positive
tumbles	negative
squeal	negative
unproductive	negative
tarnishes	negative
silly	negative
drain	negative
unsecure	negative
detraction	negative
wisely	positive
disavowal	negative
undignified	negative
preeminent	positive
weakening	negative
killer	negative
misunderstanding	negative
squabbling	negative
remunerate	positive
fascinatingly	positive
hiss	negative
hissing	negative
suave	positive
merit	positive
rectification	positive
opulent	positive
scaly	negative
dissolute	negative
inexpertly	negative
dishonestly	negative
ultimatums	negative
tantalize	positive
enthralled	positive
pauper	negative
flickering	negative
puny	negative
full-blown	negative
testily	negative
menacingly	negative
wastefulness	negative
droop	negative
morality	positive
worthy	positive
promises	positive
instigate	negative
dragoon	negative
self-sufficiency	positive
dissatisfaction	negative
heartbreakingly	negative
lovably	positive
fastuous	negative
slowww	negative
despoil	negative
scratched	negative
ecstasies	positive
unrest	negative
radiant	positive
tempt	positive
insufficiency	negative
rejoicing	positive
dependable	positive
exorbitantance	negative
occlude	negative
flakey	negative
worth-while	positive
worthwhile	positive
disinterest	negative
examplary	positive
infuriatingly	negative
rich	positive
tingling	negative
gruff	negative
mischievous	negative
furiously	negative
sensationally	positive
oppressively	negative
fatcats	negative
defeat	positive
reliable	positive
exellent	positive
fast	positive
disabled	negative
impressively	positive
insufferably	negative
sweetness	positive
manageable	positive
decisiveness	positive
scratchy	negative
ironic	negative
swindle	negative
intimidatingly	negative
scourge	negative
spiritual	positive
discourage	negative
rebuff	negative
oppression	negative
workable	positive
faithfulness	positive
entertain	positive
reprehensible	negative
wreaks	negative
fantastically	positive
vibrates	negative
uplifting	positive
vicious	negative
sinfully	negative
dumb	negative
licentiously	negative
ghetto	negative
viciousness	negative
provoke	negative
overwhelm	negative
spoon-fed	negative
prevaricate	negative
jeers	negative
high-priced	negative
torrent	negative
irretating	negative
scathing	negative
overreach	negative
grand	positive
misuse	negative
thoughtlessness	negative
idle	negative
intrude	negative
lukewarm	negative
rip-off	negative
outrageous	negative
sophisticated	positive
nervously	negative
grieve	negative
wonders	positive
sumptuously	positive
devastate	negative
vibrate	negative
trample	negative
struggling	negative
indignantly	negative
zenith	positive
easy-to-use	positive
hands-down	positive
fascinate	positive
over-balanced	negative
suffered	negative
faultless	positive
irregular	negative
grotesque	negative
fiery	positive
playful	positive
despondently	negative
groundbreaking	positive
grainy	negative
respite	positive
unsupported	negative
nefarious	negative
goodwill	positive
suck	negative
gape	negative
squeaks	negative
litigious	negative
helpless	negative
twisted	negative
outmoded	negative
vilify	negative
lurk	negative
naively	negative
steadiness	positive
geeky	positive
misreading	negative
taunt	negative
quack	negative
record-setting	positive
euphoric	positive
nebulously	negative
dreadful	negative
diatribes	negative
luster	positive
mangling	negative
eagerly	positive
irritable	negative
leer	negative
rigidity	negative
misrepresentation	negative
junkyard	negative
eye-catch	positive
ebullience	positive
foreboding	negative
ineloquent	negative
issues	negative
scandalously	negative
inadvisably	negative
dotingly	positive
fertile	positive
glaringly	negative
irksomely	negative
supremacy	positive
radiance	positive
subpoena	negative
ruts	negative
undisputable	positive
faze	negative
ill-conceived	negative
hated	negative
haze	negative
effortlessly	positive
destains	negative
stuttered	negative
outrages	negative
snobby	negative
viper	negative
stylishly	positive
outdo	positive
endorse	positive
matte	negative
mislike	negative
flake	negative
ruined	negative
vibrantly	positive
repulse	negative
shortsightedness	negative
simplest	positive
unnaturally	negative
nicely	positive
liberty	positive
savages	negative
frazzled	negative
wound	negative
rigidness	negative
repulsively	negative
optimal	positive
waste	negative
disinclined	negative
defeating	positive
goading	negative
satisfying	positive
starve	negative
dissatisfies	negative
lamentably	negative
perturbed	negative
pain	negative
hubris	negative
judicious	positive
touted	negative
inessential	negative
displeasure	negative
disconcerting	negative
sensibly	positive
indigent	negative
disparagingly	negative
misstatement	negative
suffice	positive
invalid	negative
imprecate	negative
unachievable	negative
isolation	negative
evasive	negative
victory	positive
senile	negative
productive	positive
inequitably	negative
pleasure	positive
topnotch	positive
quandary	negative
little-known	negative
sever	negative
fury	negative
selective	positive
freedoms	positive
irrecoverably	negative
overawe	negative
insupportably	negative
hypocrites	negative
substandard	negative
mature	positive
pride	positive
partisans	negative
valor	positive
steals	negative
impartial	positive
malcontent	negative
gimmicky	negative
miraculous	positive
invidiousness	negative
enchanting	positive
inordinately	negative
poorly	negative
unabashed	positive
disrespectable	negative
overwhelmingly	negative
murderously	negative
honored	positive
rhapsodize	negative
second-class	negative
ergonomical	positive
improvement	positive
scratches	negative
well-rounded	positive
objection	negative
hasseling	negative
racy	negative
lackadaisical	negative
lucid	positive
martyrdom	negative
exacerbate	negative
strangle	negative
weirdly	negative
futuristic	positive
disgustfully	negative
gangster	negative
devastates	negative
loses	negative
disruption	negative
maladjusted	negative
skillfully	positive
favorited	positive
phenomenal	positive
obscures	negative
sunken	negative
jolly	positive
slanderer	negative
intolerable	negative
deride	negative
talents	positive
trusting	positive
subservient	negative
dropouts	negative
fortune	positive
inspiration	positive
graciousness	positive
effusive	positive
throbbed	negative
hardliner	negative
marvel	positive
innuendo	negative
hard	negative
terribleness	negative
irritate	negative
headaches	negative
honoring	positive
miserableness	negative
fervor	positive
inestimable	positive
injustice	negative
insurmountable	negative
depress	negative
misleadingly	negative
misfit	negative
thoughtfulness	positive
indignation	negative
enticing	positive
delightfulness	positive
vivacious	positive
ill-favored	negative
haywire	negative
puzzled	negative
ecstasy	positive
restructuring	positive
uncivilized	negative
sinking	negative
praise	positive
unappealing	negative
failing	negative
torture	negative
enmity	negative
sarcastically	negative
time-honored	positive
ridicule	negative
fallout	negative
reverently	positive
oddest	negative
hothead	negative
freakish	negative
distraction	negative
happiness	positive
juddering	negative
insultingly	negative
deserving	positive
mocked	negative
disagreeing	negative
second-tier	negative
strongest	positive
sillily	negative
kudos	positive
inescapable	negative
irrationality	negative
excessively	negative
nervousness	negative
fruitful	positive
kindliness	positive
rude	negative
subjugate	negative
heck	negative
timidly	negative
startlingly	negative
fatuity	negative
delightful	positive
fanatical	negative
strange	negative
strangely	negative
pessimistically	negative
hospitable	positive
whoa	positive
destroyer	negative
enrapture	positive
tenuously	negative
succeeding	positive
moribund	negative
lunatic	negative
unresolved	negative
insignificantly	negative
laudable	positive
indignant	negative
distracting	negative
horrid	negative
set-up	negative
hopeless	negative
glimmer	positive
depressing	negative
infiltrator	negative
shortsighted	negative
unprove	negative
hypocrite	negative
depraved	negative
goodly	positive
staunchly	positive
refused	negative
exemplary	positive
winners	positive
misalign	negative
loophole	negative
dictatorial	negative
pervasive	negative
meritorious	positive
scorn	negative
idolize	positive
risk	negative
felonious	negative
ripped	negative
respectable	positive
straining	negative
discompose	negative
ruffian	negative
godlike	positive
sneakily	negative
ramshackle	negative
worryingly	negative
undersized	negative
imprisonment	negative
snazzy	positive
rectify	positive
thrilling	positive
scarred	negative
illiterate	negative
killing	negative
promoter	positive
dummy-proof	positive
terrorize	negative
seamless	positive
stupidest	negative
gratified	positive
imaginative	positive
foresight	positive
jagged	negative
responsibly	positive
top-notch	positive
perversion	negative
poorer	negative
simplifying	positive
dungeon	negative
unease	negative
deviousness	negative
restlessness	negative
struggles	negative
violently	negative
intefere	negative
distasteful	negative
simplified	positive
dope	negative
favorite	positive
navigable	positive
sparkling	positive
plasticky	negative
sicken	negative
superb	positive
incongruously	negative
repression	negative
desiccate	negative
grandeur	positive
impoverished	negative
pleased	positive
mortify	negative
eccentricity	negative
sensational	positive
exuberantly	positive
morons	negative
pleasurably	positive
frazzle	negative
obstruction	negative
ill-tempered	negative
futility	negative
unpleasant	negative
terribly	negative
partisan	negative
well-run	positive
unfeeling	negative
inflammatory	negative
vestiges	negative
positive	positive
tragedy	negative
profane	negative
livid	negative
entangle	negative
fast-growing	positive
god-awful	negative
desperately	negative
frigging	negative
pathetically	negative
zeal	positive
freedom	positive
exhilaration	positive
trump	positive
enchanted	positive
favor	positive
gem	positive
risky	negative
trash	negative
slower	negative
unuseably	negative
infallibly	positive
undetermined	negative
snagging	negative
jolt	negative
suspect	negative
mightily	positive
swollen	negative
inaudible	negative
undue	negative
incompatability	negative
unnoticed	negative
irrecoverableness	negative
pitiable	negative
slashing	negative
helplessness	negative
detestably	negative
tricky	negative
smoother	positive
skimpy	negative
impending	negative
enjoyed	positive
gibber	negative
ludicrously	negative
mesmerizes	positive
taunting	negative
repudiation	negative
split	negative
terror	negative
disappointingly	negative
fib	negative
overwhelming	negative
unconditional	positive
unpopular	negative
stifle	negative
scuffs	negative
individualized	positive
sharply	negative
fiasco	negative
unkindly	negative
inanely	negative
spewed	negative
tout	negative
thumbs-up	positive
dizzy	negative
industrious	positive
undermining	negative
nettle	negative
honorable	positive
flaky	negative
stringently	negative
imminently	negative
motivated	positive
steadfastly	positive
doubts	negative
hail	positive
irked	negative
diatribe	negative
miracle	positive
restrict	negative
well-bred	positive
surpass	positive
figurehead	negative
poise	positive
disdain	negative
urgent	negative
fallaciousness	negative
pricier	negative
dissemble	negative
preposterous	negative
tattered	negative
finagle	negative
disagreed	negative
misguided	negative
slogs	negative
willingly	positive
sensation	positive
wasting	negative
rapturous	positive
luxuriant	positive
stench	negative
disrespectfulness	negative
luxuriate	positive
troublemaker	negative
outsider	negative
inadvisable	negative
liability	negative
repugnance	negative
valiant	positive
vomited	negative
inadverent	negative
thoughtlessly	negative
disillusioned	negative
rightful	positive
stew	negative
slime	negative
fearfully	negative
naïve	negative
sober	negative
guilty	negative
lackluster	negative
filthy	negative
onerous	negative
resolute	positive
eminent	positive
refuting	negative
exceptional	positive
ideal	positive
deviously	negative
stutter	negative
hallmarks	positive
proven	positive
imprecise	negative
sidetrack	negative
state-of-the-art	positive
honor	positive
exultation	positive
remarkable	positive
hardhearted	negative
incorrect	negative
vulnerable	negative
freezing	negative
hustler	negative
stumps	negative
drought	negative
fervently	positive
insinuating	negative
fuck	negative
prattle	negative
dissension	negative
unfortunate	negative
showdown	negative
self-respect	positive
invidiously	negative
illness	negative
humiliation	negative
obstructed	negative
static	negative
luminous	positive
patriot	positive
gibe	negative
dud	negative
lawful	positive
problem	negative
solace	positive
sardonic	negative
vomiting	negative
erratic	negative
disoriented	negative
distastefully	negative
slowly	negative
stress	negative
unrelentingly	negative
rascal	negative
unuseable	negative
strangest	negative
run-down	negative
droops	negative
shortchange	negative
ragged	negative
repugn	negative
decisive	positive
unbelievable	negative
dubitable	negative
profoundly	positive
obstacle	negative
distains	negative
selfishly	negative
enslave	negative
disingenuously	negative
lavishly	positive
forgetful	negative
pros	positive
gratification	positive
stainless	positive
stammer	negative
unexpected	negative
smear	negative
prohibitive	negative
obscure	negative
spoilages	negative
enfeeble	negative
illogical	negative
frost	negative
lure	negative
fancier	positive
ineligible	negative
flexibility	positive
polluters	negative
glibly	negative
unclean	negative
pompous	negative
slogging	negative
lecherous	negative
officious	negative
harass	negative
perversely	negative
screwed	negative
unskilled	negative
outcry	negative
passionate	positive
luckier	positive
deny	negative
dirt	negative
devious	negative
standout	positive
diabolical	negative
smoulder	negative
misguidance	negative
galling	negative
grisly	negative
friendly	positive
meager	negative
roomier	positive
realizable	positive
inconsequentially	negative
jealousness	negative
perish	negative
tyrant	negative
sickly	negative
flimsy	negative
tyrannical	negative
frightful	negative
paltry	negative
fuzzy	negative
intimate	positive
rapturously	positive
mistified	negative
paradoxically	negative
irresistibly	positive
mendacity	negative
patronize	negative
tramp	negative
disconsolate	negative
immorally	negative
supremely	positive
grumpish	negative
lewdness	negative
lapse	negative
feasibly	positive
thinner	positive
overstated	negative
fascism	negative
disadvantage	negative
slave	negative
misconceptions	negative
magic	positive
rattles	negative
delight	positive
woebegone	negative
disgusting	negative
oversimplify	negative
unhappily	negative
mispronounces	negative
long-time	negative
well-managed	positive
stable	positive
morbid	negative
dependably	positive
pointlessly	negative
languor	negative
repulsive	negative
fulminate	negative
despondency	negative
suffices	positive
leery	negative
rhetoric	negative
unbearablely	negative
drags	negative
dirty	negative
exorbitant	negative
horrifying	negative
phobic	negative
incorrectly	negative
harpy	negative
gain	positive
slanderously	negative
downturn	negative
enjoyably	positive
sleek	positive
rollercoaster	negative
superficially	negative
excuse	negative
marvelousness	positive
miracles	positive
overpaid	negative
sacrificed	negative
good	positive
edify	positive
incense	negative
sharpest	positive
preferable	positive
time-consuming	negative
enemy	negative
revengefully	negative
incapably	negative
emphatically	negative
fibber	negative
divisively	negative
sucky	negative
obnoxiously	negative
improvements	positive
simpler	positive
mistake	negative
shirk	negative
unlawfulness	negative
haughtily	negative
miserly	negative
ill-formed	negative
wondrous	positive
rivalry	negative
luxuriously	positive
falter	negative
loyalty	positive
superior	positive
ranted	negative
pity	negative
fawningly	negative
pale	negative
reprehensive	negative
eases	positive
nuisance	negative
top-quality	positive
fearlessly	positive
humid	negative
greatest	positive
narrower	negative
vex	negative
imbecile	negative
great	positive
fav	positive
uninsured	negative
laconic	negative
heros	positive
languish	negative
detracted	negative
undermined	negative
naughty	negative
impeccably	positive
gaining	positive
naive	negative
hiliarious	negative
self-interested	negative
lowly	negative
inconsiderate	negative
unsettle	negative
stuck	negative
impose	negative
reward	positive
uncooperative	negative
evocative	positive
impurity	negative
scoundrel	negative
soothingly	positive
louder	negative
slander	negative
flaunt	negative
tepid	negative
sedentary	negative
overbearingly	negative
inequitable	negative
well-connected	positive
inestimably	positive
miscreant	negative
undependability	negative
drastic	negative
pertinacity	negative
hogs	negative
trashed	negative
transgress	negative
intriguing	positive
pout	negative
overbalanced	negative
spiritless	negative
grouchy	negative
incendiary	negative
retract	negative
likable	positive
joke	negative
direness	negative
wretched	negative
pointless	negative
scapegoat	negative
punitive	negative
stagnant	negative
exaltedly	positive
sadden	negative
hooligan	negative
invaluablely	positive
illusions	negative
intense	negative
maneuverable	positive
disfavor	negative
gall	negative
persecution	negative
lurid	negative
exhorbitant	negative
straighten	positive
stumbles	negative
outstrip	positive
fool	negative
obscenely	negative
self-sufficient	positive
tricked	negative
pickets	negative
reject	negative
winnable	positive
incompetently	negative
fond	positive
outlaw	negative
uncomplicated	positive
unwavering	positive
warning	negative
undone	negative
pretense	negative
successfully	positive
harmoniously	positive
ignorant	negative
endorsement	positive
eyesore	negative
frustrates	negative
insults	negative
earnestness	positive
desirable	positive
maltreatment	negative
fabulous	positive
spoilled	negative
infallibility	positive
glitz	positive
miscalculate	negative
fondly	positive
unwillingly	negative
recoil	negative
wins	positive
fanaticism	negative
swipe	negative
inexplainable	negative
flee	negative
maledict	negative
imperfect	negative
disparaging	negative
magnanimously	positive
evade	negative
heretical	negative
penalty	negative
sags	negative
grim	negative
disrespectablity	negative
shadowy	negative
glistening	positive
dominated	positive
turmoil	negative
sincerely	positive
envious	positive
smoldering	negative
noxious	negative
egotistically	negative
streaky	negative
rival	negative
endorses	positive
straggle	negative
militancy	negative
worrier	negative
dissention	negative
leakages	negative
weariness	negative
exceed	positive
virulent	negative
detriment	negative
smells	negative
difficulty	negative
sermonize	negative
havoc	negative
horde	negative
refuses	negative
reactionary	negative
unsuspecting	negative
melodramatically	negative
dislocated	negative
hurtful	negative
exceedingly	positive
swankiest	positive
preferring	positive
lacks	negative
moan	negative
inundate	negative
remarkably	positive
perplex	negative
inexpert	negative
stupendously	positive
rremediable	negative
infested	negative
stresses	negative
usurper	negative
inspirational	positive
perfectly	positive
disapointed	negative
sad	negative
nauseates	negative
effectively	positive
dread	negative
nightmarishly	negative
spurious	negative
stealing	negative
untouched	negative
instrumental	positive
jealously	negative
foolproof	positive
keenness	positive
inhibition	negative
unhappy	negative
disillusionment	negative
lorn	negative
erroneous	negative
whine	negative
thrifty	positive
leverage	positive
odor	negative
flaw	negative
predicament	negative
earsplitting	negative
wrong	negative
goodness	positive
hastily	negative
miscalculation	negative
insidious	negative
resound	positive
preferably	positive
fall	negative
sincerity	positive
greatness	positive
devastatingly	negative
hate	negative
insupportable	negative
excuses	negative
resent	negative
impolitely	negative
retreat	negative
rosy	positive
tumultuous	negative
elated	positive
truant	negative
neurotic	negative
disclaim	negative
insouciance	negative
hurts	negative
depravedly	negative
sting	negative
lech	negative
drag	negative
indiscriminating	negative
sneer	negative
seriousness	negative
prolific	positive
irately	negative
delightfully	positive
disgrace	negative
pamperedly	positive
worked	positive
hardier	positive
dubious	negative
scrambling	negative
spitefulness	negative
profanity	negative
indiscriminate	negative
unwarranted	negative
quarrellous	negative
pan	negative
drunken	negative
refuse	negative
prefered	positive
raging	negative
oblique	negative
hacks	negative
upscale	positive
improved	positive
renaissance	positive
excellency	positive
flagrant	negative
virtuously	positive
well-established	positive
overblown	negative
laudably	positive
entranced	positive
tenaciously	positive
quarrellously	negative
grind	negative
devastated	negative
masterpiece	positive
exorbitantly	negative
thoughtfully	positive
unaffordable	negative
itchy	negative
privilege	positive
multi-polarization	negative
disgustingly	negative
gruesomely	negative
dungeons	negative
ungrateful	negative
flaking	negative
ridiculously	negative
multi-purpose	positive
prestige	positive
unaccessible	negative
shimmy	negative
disliking	negative
violators	negative
rife	negative
wicked	negative
rampage	negative
impropriety	negative
lyrical	positive
sporty	positive
incompatibility	negative
smiles	positive
deprived	negative
enthusiastic	positive
mockingly	negative
tawdry	negative
flashy	positive
economical	positive
predatory	negative
respectfully	positive
violate	negative
grievously	negative
ready	positive
vexingly	negative
worthlessness	negative
ignorance	negative
stinging	negative
flirty	negative
exasperation	negative
revengeful	negative
friction	negative
occluded	negative
discouragement	negative
disturbance	negative
ineffectual	negative
peril	negative
undependable	negative
weaken	negative
spontaneous	positive
imperious	negative
fruitlessly	negative
stupidly	negative
tenuous	negative
travesties	negative
heroize	positive
unconvincingly	negative
incorrigible	negative
empowerment	positive
harbors	negative
uglier	negative
disastrous	negative
exalt	positive
tenderly	positive
unfavorable	negative
fastest-growing	positive
ultra-hardline	negative
unlimited	positive
foully	negative
fastidiously	negative
sloow	negative
huckster	negative
failures	negative
shabby	negative
symptom	negative
prideful	negative
hardships	negative
halfhearted	negative
dismalness	negative
disavow	negative
detesting	negative
underestimate	negative
dissidence	negative
whoooa	positive
snub	negative
revolt	negative
lambast	negative
heartbreaker	negative
whooa	positive
flutter	positive
turbulent	negative
madly	negative
despairingly	negative
ingenuous	positive
rupture	negative
infraction	negative
suitable	positive
mischievously	negative
implicate	negative
infamy	negative
sore	negative
woefully	negative
gaudy	negative
undefined	negative
startle	negative
disproportionate	negative
insubordinate	negative
enchant	positive
evaluative	positive
fascination	positive
spank	negative
disillusions	negative
uproarously	negative
vociferously	negative
vexation	negative
undermine	negative
petrify	negative
dishearteningly	negative
evenly	positive
oversight	negative
stupified	negative
outbreak	negative
interferes	negative
poky	negative
negligent	negative
swift	positive
heal	positive
doggedly	negative
infringements	negative
stain	negative
furious	negative
fidgety	negative
gripe	negative
disorder	negative
unscrupulous	negative
helpful	positive
inflammation	negative
ruinous	negative
stronger	positive
unsupportive	negative
healthy	positive
fine-looking	positive
whore	negative
splatter	negative
titillatingly	positive
restful	positive
riled	negative
unacceptablely	negative
youthful	positive
shoddy	negative
hassled	negative
soundly	positive
infidel	negative
deference	positive
worsen	negative
tangles	negative
nagging	negative
unbeatable	positive
praiseworthy	positive
relief	positive
vengeance	negative
stern	negative
inundated	negative
lush	positive
scuff	negative
desirous	positive
grudge	negative
risks	negative
warmhearted	positive
slap	negative
simplifies	positive
offender	negative
self-criticism	negative
proficient	positive
felon	negative
well-wishers	positive
tingled	negative
junky	negative
slothful	negative
traumatized	negative
torturing	negative
tank	negative
ordeal	negative
mighty	positive
modesty	positive
irrecoverable	negative
underpowered	negative
inadequately	negative
matchless	positive
dizzing	negative
enjoys	positive
drips	negative
unintelligile	negative
ill-sorted	negative
doldrums	negative
spilling	negative
destruction	negative
irk	negative
limitations	negative
stimulative	positive
eloquent	positive
virus	negative
welcome	positive
untenable	negative
strenuous	negative
pain-free	positive
pathetic	negative
unsophisticated	negative
fault	negative
timidity	negative
resigned	negative
disdained	negative
reverent	positive
sueing	negative
supurbly	positive
laughably	negative
runaway	negative
scorchingly	negative
inflationary	negative
inextricable	negative
dump	negative
superfluous	negative
romanticize	positive
ridicules	negative
insulting	negative
ill-used	negative
sarcastic	negative
harangue	negative
stuffy	negative
shocked	negative
pervert	negative
noiseless	positive
notoriously	negative
graceful	positive
gutless	negative
unable	negative
repulsed	negative
slog	negative
expansive	positive
disloyal	negative
promise	positive
severity	negative
wack	negative
protesting	negative
malign	negative
pessimistic	negative
eye-catching	positive
tantrum	negative
pokey	negative
regally	positive
slow	negative
negation	negative
humane	positive
fraudulent	negative
temptation	negative
miseries	negative
shake	negative
gloatingly	negative
sensitive	positive
ebullient	positive
wickedness	negative
letch	negative
exceptionally	positive
distressing	negative
uncreative	negative
despoiler	negative
delicacy	positive
hostility	negative
heavy-handed	negative
subvert	negative
steeply	negative
diappointed	negative
god-send	positive
impossibly	negative
obtainable	positive
uneasily	negative
nemesis	negative
ilu	positive
saggy	negative
smitten	positive
languid	negative
oddity	negative
enterprising	positive
leakage	negative
lead	positive
mar	negative
sinisterly	negative
sweeping	positive
disgracefully	negative
fun	positive
uncivil	negative
stimulating	positive
insufficient	negative
sluts	negative
ferociously	negative
novelty	positive
profuse	positive
swamped	negative
retardedness	negative
furor	negative
wimpy	negative
suspicious	negative
surmount	positive
womanizer	negative
reviled	negative
irreconcilable	negative
rapport	positive
obese	negative
disobedient	negative
shamefulness	negative
rockstar	positive
rotten	negative
displeased	negative
repulsiveness	negative
frigid	negative
tentatively	negative
proactive	positive
stridently	negative
moot	negative
trauma	negative
vivid	positive
teasingly	negative
mortification	negative
weep	negative
fashionable	positive
utterly	negative
mercilessly	negative
martyrdom-seeking	negative
unkind	negative
tarnished	negative
smug	negative
pugnacious	negative
prospros	positive
inventive	positive
worst	negative
deprive	negative
ulterior	negative
ingenuity	positive
fatuously	negative
inviolate	positive
harasses	negative
impotent	negative
indefensible	negative
itching	negative
snappishly	negative
skittishly	negative
hideously	negative
forfeit	negative
splitting	negative
vomit	negative
joy	positive
unimaginably	negative
extraordinary	positive
twists	negative
proves	positive
jovial	positive
hotcakes	positive
legendary	positive
futilely	negative
scandels	negative
engaging	positive
impractical	negative
murder	negative
togetherness	positive
loveless	negative
hollow	negative
happy	positive
instigator	negative
steady	positive
dextrous	positive
inteferes	negative
glorious	positive
mourner	negative
disapointment	negative
hapless	negative
elegantly	positive
perverts	negative
frightening	negative
downfall	negative
savings	positive
guidance	positive
shaky	negative
listless	negative
one-sided	negative
unsure	negative
explode	negative
interesting	positive
pigs	negative
free	positive
fickle	negative
enflame	negative
offensively	negative
laughingstock	negative
resplendent	positive
firmer	positive
righteous	positive
mesmerize	positive
loopholes	negative
frustrations	negative
fascist	negative
warped	negative
exceeded	positive
joyously	positive
unproving	negative
frighten	negative
enjoying	positive
difficulties	negative
disquietingly	negative
emaciated	negative
unworkable	negative
zippy	positive
immaculate	positive
recommend	positive
hang	negative
hatefully	negative
imposers	negative
despotism	negative
secure	positive
doom	negative
taboo	negative
pettifog	negative
wrinkle	negative
sack	negative
ignominy	negative
scariest	negative
presumptuous	negative
fallacious	negative
examplar	positive
sprightly	positive
excallent	positive
virtue	positive
enrage	negative
self-coup	negative
dishonest	negative
rot	negative
unfulfilled	negative
mundane	negative
exuberant	positive
dumping	negative
versatile	positive
mysteriously	negative
timidness	negative
ingrate	negative
downheartedly	negative
inadverently	negative
fatigue	negative
glow	positive
rattle	negative
flawed	negative
prudent	positive
lags	negative
snappish	negative
rejoice	positive
unjustified	negative
malice	negative
grate	negative
passe	negative
vengefulness	negative
scary	negative
insatiable	negative
skinny	negative
lumpy	negative
enthuse	positive
unjustifiably	negative
faults	negative
festive	positive
swagger	negative
devout	positive
dirts	negative
sharp	positive
untested	negative
expire	negative
jeopardize	negative
impudent	negative
haunting	negative
enticed	positive
thirst	negative
inequalities	negative
flawlessly	positive
readable	positive
egregiously	negative
redundancy	negative
immodest	negative
downhearted	negative
disruptive	negative
diabolically	negative
ironical	negative
scarier	negative
exhaust	negative
muscle-flexing	negative
panders	negative
shatter	negative
maturely	positive
genuine	positive
envy	positive
regrets	negative
limited	negative
unparalleled	positive
obscene	negative
intransigence	negative
inexcusably	negative
distract	negative
powerless	negative
worsening	negative
toll-free	positive
invalidity	negative
embroilment	negative
feign	negative
perilously	negative
obnoxious	negative
famously	positive
draconian	negative
starkly	negative
scramble	negative
sneak	negative
superiority	positive
fundamentalism	negative
fleer	negative
interruption	negative
invincible	positive
snare	negative
irritation	negative
distortion	negative
luckiest	positive
negativity	negative
disorderly	negative
distress	negative
erase	negative
healthful	positive
handier	positive
twist	negative
insufficiently	negative
irascible	negative
leads	positive
malicious	negative
spoon-feed	negative
traduce	negative
underpaid	negative
trapped	negative
punch	negative
super	positive
personages	positive
exceeding	positive
supported	positive
startling	negative
worries	negative
liking	positive
wrestle	negative
niggles	negative
flighty	negative
disagreeably	negative
venom	negative
rhetorical	negative
less-developed	negative
dreamland	positive
exagerates	negative
mad	negative
honest	positive
flourish	positive
integrated	positive
injudicious	negative
torturously	negative
fat	negative
jeering	negative
revoke	negative
suppress	negative
inflammed	negative
saintliness	positive
enviousness	positive
smoothly	positive
fraught	negative
magnificent	positive
inconsiderately	negative
deginified	positive
excite	positive
meddle	negative
incompliant	negative
deplorably	negative
despised	negative
paranoid	negative
skillful	positive
facilitate	positive
horrified	negative
obstructing	negative
staunch	positive
undercuts	negative
warmth	positive
warm	positive
hot	positive
exaggeration	negative
impugn	negative
immature	negative
inelegance	negative
noise	negative
plunder	negative
remission	positive
improves	positive
shameful	negative
stains	negative
fame	positive
fusty	negative
sh*t	negative
irrecoverablenesses	negative
rattled	negative
drowning	negative
paucity	negative
flat-out	negative
shrew	negative
fathomless	negative
streamlined	positive
hating	negative
fave	positive
dissapointed	negative
panoramic	positive
uphold	positive
suspicions	negative
obliterated	negative
sorrowful	negative
prosperous	positive
gusto	positive
genius	positive
plusses	positive
disadvantaged	negative
proprietary	negative
radical	negative
romantic	positive
reclaim	positive
forged	negative
villainous	negative
dumped	negative
dissonant	negative
lies	negative
ironies	negative
overpayed	negative
revulsion	negative
horrendously	negative
trivially	positive
noteworthy	positive
sufficiently	positive
sloppy	negative
trustworthiness	positive
suspicion	negative
ingenuously	positive
dreary	negative
hardheaded	negative
kid-friendly	positive
stunning	positive
overpower	negative
sensible	positive
refinement	positive
stranger	negative
spoil	negative
quiet	positive
short-lived	negative
last-ditch	negative
grating	negative
disquietude	negative
subsidize	positive
fissures	negative
feeblely	negative
negative	negative
ideally	positive
lanky	negative
expeditiously	positive
emptiness	negative
stalemate	negative
exaggerate	negative
majesty	positive
sues	negative
spectacular	positive
unsteady	negative
useless	negative
exalting	positive
douchebags	negative
draconic	negative
swank	positive
self-determination	positive
rejuvenating	positive
disordered	negative
surrender	negative
invader	negative
indiscernible	negative
jobless	negative
war-like	negative
gripes	negative
unintelligible	negative
revitalize	positive
paramount	positive
overtaking	positive
hysteric	negative
empower	positive
failure	negative
glamorous	positive
fatalistically	negative
supportive	positive
picky	negative
paradise	positive
stability	positive
glee	positive
scrambles	negative
panicked	negative
wrangle	negative
unabashedly	positive
lifesaver	positive
mire	negative
notorious	negative
onerously	negative
repress	negative
reckless	negative
pratfall	negative
usable	positive
halfheartedly	negative
peaceable	positive
dexterously	positive
hug	positive
infidels	negative
discomfort	negative
nauseatingly	negative
relapse	negative
moron	negative
glut	negative
dispirited	negative
disputable	negative
smudge	negative
inordinate	negative
suavely	positive
resilient	positive
despise	negative
hairloss	negative
incite	negative
losses	negative
miserable	negative
smouldering	negative
effective	positive
vibration	negative
fresh	positive
sublime	positive
substantive	positive
vindictiveness	negative
rejecting	negative
indeterminable	negative
isolated	negative
smile	positive
effectiveness	positive
stupor	negative
perverse	negative
vibrated	negative
hoard	negative
hardened	negative
law-abiding	positive
nicer	positive
flareups	negative
exhausted	negative
motley	negative
handicapped	negative
inexorable	negative
inclement	negative
precipitous	negative
ruthlessness	negative
desiring	positive
equivocal	negative
retaliate	negative
instructive	positive
prominent	positive
snag	negative
nurturing	positive
easy	positive
ineptitude	negative
like	positive
jaw-droping	positive
insincerity	negative
wholeheartedly	positive
truthful	positive
unviewable	negative
stymied	negative
revenge	negative
idiocies	negative
dishonorablely	negative
tragically	negative
hardy	positive
extravagant	negative
enthral	positive
energy-saving	positive
mishap	negative
elation	positive
suppression	negative
slowed	negative
dizzingly	negative
phony	negative
elevate	positive
humour	positive
timely	positive
nimble	positive
fuss	negative
dignity	positive
scrap	negative
egotistical	negative
friggin	negative
pales	negative
inaptitude	negative
upliftment	positive
logical	positive
sticky	negative
extinguish	negative
jubilant	positive
exploit	negative
distraughtness	negative
leading	positive
hater	negative
strict	negative
killjoy	negative
revert	negative
irreplacible	negative
stumble	negative
pepped	positive
dumbfounded	positive
presumptuously	negative
explosive	negative
trendy	positive
infuriated	negative
infamously	negative
irreproachable	positive
gainfully	positive
shroud	negative
outrageously	negative
impedance	negative
tired	negative
rejection	negative
trumpet	positive
worthlessly	negative
gracelessly	negative
straightforward	positive
deprave	negative
sensationalize	negative
inexorably	negative
mocks	negative
grumpiest	negative
divine	positive
favored	positive
wonderful	positive
fragile	negative
over-hyped	negative
reproachful	negative
unequivocal	positive
mawkishly	negative
promised	positive
splendor	positive
spacious	positive
destitute	negative
flatteringly	positive
paradoxical	negative
incoherently	negative
toil	negative
inactive	negative
fortunately	positive
slogged	negative
indulge	negative
procrastinates	negative
restricted	negative
sneeringly	negative
entertaining	positive
everlasting	positive
imprudent	negative
fatefully	negative
overpriced	negative
unscrupulously	negative
f**k	negative
wild	negative
wretchedly	negative
unusably	negative
shirker	negative
unprepared	negative
recover	positive
wrath	negative
overwhelmed	negative
vague	negative
get-rich	negative
grossly	negative
nitpick	negative
seedy	negative
franticly	negative
punishable	negative
flounder	negative
hilarious	positive
snob	negative
overplay	negative
rantingly	negative
splendidly	positive
discord	negative
elan	positive
fucking	negative
earnest	positive
job-killing	negative
extort	negative
heavyhearted	negative
stressful	negative
epidemic	negative
hypocrisy	negative
optimism	positive
overloaded	negative
ultimatum	negative
pique	negative
satirize	negative
enjoy	positive
incognizant	negative
grumble	negative
floored	negative
stiflingly	negative
world-famous	positive
gloomy	negative
evils	negative
regretted	negative
problems	negative
shipwreck	negative
slick	positive
soft	positive
grouch	negative
upgraded	positive
overacted	negative
fastidious	negative
hatefulness	negative
imprudence	negative
painfull	negative
rumours	negative
loathsomely	negative
stellarly	positive
stigmatize	negative
intoxicate	negative
imposing	negative
doubtful	negative
soulful	positive
lackey	negative
tease	negative
dote	positive
puppet	negative
disrespecting	negative
kindness	positive
modern	positive
revelation	positive
lazy	negative
subservience	negative
inappropriately	negative
exhilarate	positive
ineffectually	negative
disrepute	negative
smash	negative
unsound	negative
unemployed	negative
spellbound	positive
guiltless	positive
uncertain	negative
worrying	negative
formidable	positive
plotters	negative
expel	negative
inferiority	negative
succeeds	positive
mangled	negative
disturbingly	negative
slur	negative
incomparably	negative
gruesome	negative
passive	negative
stutters	negative
terrible	negative
exhilaratingly	positive
unattractive	negative
pretend	negative
flares	negative
overzealously	negative
malevolently	negative
energy-efficient	positive
spoils	negative
embarrassing	negative
subjection	negative
inconstant	negative
hallmark	positive
refute	negative
harassment	negative
forgetfully	negative
insightfully	positive
gibberish	negative
easygoing	positive
detracts	negative
overrated	negative
famous	positive
dishearten	negative
flare	negative
shady	negative
ominous	negative
well-intentioned	positive
recession	negative
irrelevance	negative
instability	negative
emasculate	negative
kaput	negative
windfall	positive
enviousness	negative
screwed-up	negative
obsessions	positive
indulgence	positive
peach	positive
unfaithfully	negative
rampant	negative
shimmeringly	positive
selfinterested	negative
unsatisfactory	negative
offensive	negative
taxing	negative
outperforms	positive
savage	negative
discontinuity	negative
lovely	positive
gritty	negative
risk-free	positive
sourly	negative
prudently	positive
obscurity	negative
pig	negative
scathingly	negative
nourishment	positive
repetitive	negative
disgustedly	negative
desiccated	negative
problem-solver	positive
unquestionable	positive
remorseful	negative
stiff	negative
shame	negative
occludes	negative
weakness	negative
flaws	negative
traitor	negative
dreadfulness	negative
spooky	negative
unreachable	negative
disaster	negative
worthless	negative
steadiest	positive
electrify	positive
impress	positive
humiliate	negative
sickness	negative
instigators	negative
obtuse	negative
enraging	negative
profusion	positive
undamaged	positive
impunity	negative
well-known	positive
disquiet	negative
stumped	negative
imprison	negative
misrepresent	negative
subversion	negative
villainously	negative
securely	positive
well-being	positive
marvels	positive
solicitude	negative
misjudge	negative
spinster	negative
fervidly	positive
misinform	negative
misfortune	negative
fright	negative
unsettling	negative
egregious	negative
disapointing	negative
favorable	positive
unexpectedly	negative
refutes	negative
frolic	positive
unfriendly	negative
replaceable	positive
responsive	positive
galls	negative
indecent	negative
wilt	negative
oddities	negative
deplorable	negative
prejudice	negative
mashed	negative
endorsed	positive
wince	negative
striving	positive
sloww	negative
resistance	negative
harden	negative
inaction	negative
repudiate	negative
right	positive
idiocy	negative
flatter	positive
promising	positive
infallible	positive
embattled	negative
muddy	negative
empathy	positive
stun	negative
unjustifiable	negative
overdue	negative
sweaty	negative
severe	negative
unassailable	positive
needless	negative
dislike	negative
meanness	negative
scandal	negative
futile	negative
rut	negative
infection	negative
shrivel	negative
uncomfortable	negative
divisive	negative
mesmerizing	positive
gratify	positive
illuminati	positive
messes	negative
slump	negative
lied	negative
shimmer	negative
splendid	positive
insurmountably	negative
fudge	negative
flattering	positive
devil	negative
inoperable	negative
drop-out	negative
scarcity	negative
unusable	negative
impertinent	negative
vouchsafe	positive
enjoyment	positive
user-replaceable	positive
perversity	negative
dismayed	negative
stinks	negative
dupe	negative
retard	negative
deplete	negative
discontinuous	negative
unleash	negative
wretchedness	negative
finest	positive
direly	negative
glitches	negative
pander	negative
heartless	negative
disasterous	negative
sexy	positive
intelligent	positive
hostage	negative
fiction	negative
impolitic	negative
regret	negative
lie	negative
foul	negative
miserably	negative
first-class	positive
harm	negative
lifeless	negative
unproved	negative
polite	positive
sucked	negative
enjoyable	positive
unbound	positive
divergent	negative
lone	negative
slowest	negative
forlorn	negative
uneven	negative
weird	negative
ill-fated	negative
inaccuracy	negative
egomania	negative
disingenuous	negative
rusty	negative
upheaval	negative
roadblocks	negative
farce	negative
unsavory	negative
recessionary	negative
dignified	positive
warp	negative
subdued	negative
seethe	negative
meticulously	positive
susceptible	negative
diffidence	negative
sunder	negative
inhibit	negative
revolutionized	positive
justly	positive
harried	negative
funnily	negative
queer	negative
outshine	positive
stink	negative
entice	positive
frets	negative
mope	negative
harboring	negative
topple	negative
hardball	negative
variety	positive
devilishly	negative
trusted	positive
wearisome	negative
liar	negative
renowned	positive
pessimism	negative
fumble	negative
dunce	negative
delicate	positive
unfunded	negative
obstruct	negative
unnatural	negative
ravage	negative
poetic	positive
strained	negative
mystify	negative
excellence	positive
testy	negative
gauche	negative
woo	positive
sidetracked	negative
taunts	negative
jutter	negative
ineloquently	negative
skilled	positive
revolutionary	positive
fabulously	positive
inexperience	negative
sulk	negative
flareup	negative
reasoned	positive
disrespectful	negative
dumbfound	negative
saver	positive
oppress	negative
irritations	negative
hindrance	negative
expunge	negative
wary	negative
plague	negative
fret	negative
simplistic	negative
oversights	negative
leak	negative
deteriorate	negative
preferes	positive
disputed	negative
imperil	negative
righten	positive
fanatic	negative
picket	negative
overact	negative
endearing	positive
uncomfy	negative
upbraid	negative
glitch	negative
reluctance	negative
robust	positive
wheedle	negative
intransigent	negative
ineffectiveness	negative
senseless	negative
slug	negative
enchantingly	positive
irresponsible	negative
exile	negative
expertly	positive
importunate	negative
excruciating	negative
spews	negative
prohibitively	negative
wrinkled	negative
ostracize	negative
destabilisation	negative
suffers	negative
softer	positive
hates	negative
fractiously	negative
miser	negative
wealthy	positive
outstandingly	positive
ominously	negative
wellbeing	positive
paranoia	negative
subpoenas	negative
effigy	negative
implausible	negative
exhaustion	negative
undaunted	positive
overlook	negative
neglect	negative
impatiently	negative
insane	negative
fluent	positive
flabbergast	negative
insensible	negative
foremost	positive
monotony	negative
oblivious	negative
fiendish	negative
pugnacity	negative
prik	negative
dilly-dally	negative
dismayingly	negative
mordantly	negative
sociable	positive
outraged	negative
unneeded	negative
mockery	negative
patience	positive
glowing	positive
forbid	negative
unreliable	negative
tanks	negative
destitution	negative
polluter	negative
drunkard	negative
falsify	negative
snagged	negative
strikingly	positive
painful	negative
insubstantially	negative
ill-usage	negative
radically	negative
top	positive
lewd	negative
undissolved	negative
difficult	negative
disparage	negative
effusively	positive
shemale	negative
laughable	negative
farfetched	negative
peacekeepers	positive
restless	negative
inconsequential	negative
prudence	positive
excellant	positive
despicable	negative
nobly	positive
jittery	negative
elegant	positive
inviolable	positive
inconceivably	negative
trustworthy	positive
wows	positive
supple	positive
unconstitutional	negative
issue	negative
encouragement	positive
incompetent	negative
smudged	negative
vindictive	negative
merciful	positive
sucker	negative
rabid	negative
spendy	negative
irks	negative
redundant	negative
thrill	positive
underdog	negative
problem-free	positive
golden	positive
prodigy	positive
ugh	negative
repugnant	negative
rejuvenate	positive
slumping	negative
emergency	negative
petrified	negative
ploy	negative
equitable	positive
prodigious	positive
died	negative
ignoble	negative
overstates	negative
mispronounce	negative
insignificant	negative
detract	negative
heinous	negative
hypocritically	negative
dragging	negative
truthfulness	positive
objectionable	negative
pleasing	positive
quibble	negative
simplify	positive
inefficiency	negative
thwart	negative
glory	positive
felicitate	positive
succeed	positive
fail	negative
villify	negative
effusiveness	positive
toxic	negative
encouraging	positive
forswear	negative
imperialist	negative
raked	negative
miff	negative
foe	negative
travesty	negative
exclusion	negative
subversive	negative
spookiest	negative
hallucination	negative
heartening	positive
depression	negative
entrap	negative
irreparable	negative
hotbeds	negative
disgusted	negative
impair	negative
rape	negative
discomfititure	negative
displaced	negative
self-satisfaction	positive
unwise	negative
disrupt	negative
scolded	negative
smart	positive
hateful	negative
regal	positive
marveled	positive
fatalistic	negative
inopportune	negative
dexterous	positive
reconcile	positive
statuesque	positive
peppy	positive
subversively	negative
panick	negative
remorselessly	negative
gumption	positive
outbursts	negative
eventful	positive
inhospitable	negative
euphorically	positive
perfection	positive
jam	negative
ecenomical	positive
innovative	positive
draining	negative
satisfactory	positive
rapture	positive
slaughtered	negative
obsessiveness	negative
unthinkable	negative
raptureous	positive
uninformed	negative
oversize	negative
inconsequently	negative
joyous	positive
harridan	negative
whining	negative
unnerving	negative
speedy	positive
likes	positive
fictional	negative
prate	negative
dishonor	negative
fevers	negative
fatal	negative
oppressors	negative
dissident	negative
wise	positive
propaganda	negative
quibbles	negative
infections	negative
gossip	negative
mulish	negative
indecisively	negative
reputation	positive
discrepant	negative
so-cal	negative
menial	negative
dismaying	negative
frozen	negative
plight	negative
plentiful	positive
harrow	negative
disconcerted	negative
restored	positive
inglorious	negative
wholesome	positive
levity	positive
weaknesses	negative
myth	negative
lucky	positive
erode	negative
maliciously	negative
tantalizing	positive
solemn	negative
mock	negative
inequities	negative
domineering	negative
domineer	negative
rock-star	positive
incapable	negative
languorous	negative
richness	positive
touts	negative
skeletons	negative
peeled	negative
disobey	negative
unforgettable	positive
inflated	negative
inexpensive	positive
spellbinding	positive
pleasant	positive
desertion	negative
incredulous	negative
mortified	negative
grace	positive
encroach	negative
warmer	positive
richly	positive
polarisation	negative
wowed	positive
improve	positive
illegally	negative
dissocial	negative
throbs	negative
inextricably	negative
lull	negative
integral	positive
swiftness	positive
momentous	positive
piety	positive
unhelpful	negative
overheat	negative
estranged	negative
unseemly	negative
heroic	positive
doomed	negative
violent	negative
loathly	negative
jerk	negative
skittish	negative
noble	positive
efficacious	positive
fried	negative
die	negative
lividly	negative
elite	positive
extraordinarily	positive
trusty	positive
mudslinging	negative
soreness	negative
erroneously	negative
snarky	negative
hazy	negative
smoothes	positive
toughest	positive
pretentiously	negative
instable	negative
loath	negative
interruptions	negative
faint	negative
stupid	negative
protests	negative
euphoria	positive
solicitously	positive
untrue	negative
destroy	negative
unproven	negative
imperfection	negative
nosey	negative
pitilessly	negative
fantastic	positive
faulty	negative
fine	positive
jitter	negative
irrepressible	negative
ruining	negative
vexing	negative
exciting	positive
jerky	negative
smokescreen	negative
uproariously	negative
sputter	negative
lecher	negative
loser	negative
forgetfulness	negative
wowing	positive
panicky	negative
progressive	positive
unravel	negative
suffer	negative
oppose	negative
irresponsibly	negative
enhance	positive
terrific	positive
tiresome	negative
upsets	negative
excellently	positive
propitious	positive
upliftingly	positive
disregardful	negative
devoid	negative
pains	negative
fervent	positive
felicity	positive
exuberance	positive
starvation	negative
villianously	negative
threaten	negative
inappropriate	negative
imaginary	negative
impudently	negative
enervate	negative
flabbergasted	negative
dripping	negative
innocuous	positive
syndrome	negative
hard-hit	negative
fleeting	negative
surreal	positive
indolent	negative
hazard	negative
infernal	negative
overemphasize	negative
pestilent	negative
penalize	negative
recourses	negative
disaffirm	negative
delicious	positive
tolerable	positive
fumes	negative
strike	negative
supports	positive
oppressive	negative
slaughter	negative
lemon	negative
stressfully	negative
garish	negative
dissuasive	negative
obsession	positive
superstitious	negative
sagged	negative
handy	positive
disliked	negative
inveigle	negative
shrill	negative
dire	negative
non-confidence	negative
incomplete	negative
disgustful	negative
invasive	negative
sour	negative
gasp	negative
stricken	negative
warily	negative
misunderstood	negative
portable	positive
fashionably	positive
exonerate	positive
unwieldy	negative
prestigious	positive
ire	negative
detestable	negative
ding	negative
fortuitously	positive
freed	positive
educated	positive
positives	positive
painfully	negative
dispirit	negative
excel	positive
outcast	negative
helping	positive
rants	negative
rough	negative
discriminatory	negative
discontent	negative
drones	negative
energize	positive
originality	positive
inarticulate	negative
deploringly	negative
haphazard	negative
impatient	negative
imperiously	negative
endorsing	positive
exagerated	negative
tragic	negative
scared	negative
deprecate	negative
injurious	negative
filth	negative
mysterious	negative
taut	negative
outrageousness	negative
willingness	positive
unlicensed	negative
yay	positive
overtaxed	negative
rewardingly	positive
unspeakablely	negative
unpleasantries	negative
phenomenally	positive
undesirable	negative
titillate	positive
lacking	negative
traumatic	negative
illegitimate	negative
distressed	negative
ingeniously	positive
slammin	positive
trivial	negative
gracefully	positive
disconcert	negative
discombobulate	negative
pitiful	negative
transgression	negative
enhances	positive
grudges	negative
mislead	negative
whores	negative
suspiciously	negative
fat-cats	negative
wow	positive
infected	negative
diametrically	negative
limp	negative
ecstatic	positive
inimically	negative
sugarcoated	negative
inaccuracies	negative
stump	negative
effusion	positive
unfazed	positive
prosper	positive
smarter	positive
derisive	negative
recklessly	negative
outshone	positive
unraveled	negative
engrossing	positive
obscured	negative
disappoint	negative
diplomatic	positive
scar	negative
indiscretion	negative
heedless	negative
effortless	positive
uprising	negative
troubling	negative
precisely	positive
well-informed	positive
squabble	negative
